{
  "grid": [
    "GGGGGGGGGGGGGGGGGGGG",
    "GGGGGGGGGGGGGGGGGGGG",
    "GGGGGGGGGGGGGGGGGGGG",
    "GGGGGGGGGGGCGGGGGGGG",
    "GGGGGGGGGGGGGGGGGGGG",
    "GGGGGEGGGGGGGGGGGGGG",
    "GGGGGGGGGGGGGGGGGGGG",
    "GGGGGGDGGGGGGGGGGGGG",
    "GGGGGGGGGGGGGGGGGGGG",
    "GGGGGGGGGGGGGGGGGGGG",
    "GGGGGGGGGGGGGGGGGGGG",
    "GGGGGGGGGGGGGGGGGGGG",
    "GGGGGGGGGGGGGGGGGGGG",
    "GGGGGGGGGGGGGGGGGGGG",
    "GGGGGGGGGGGGGGGGGGGG",
    "GGGGGGGGGGGGGGGGGGGG",
    "GGGGGGGGGGGGGGGGGGGG",
    "GGGGGGGGGGGGGGGGGGGG",
    "GGGGGGGGGGGGGGGGGGGG",
    "GGGGGGGGGGGGGGGGGGGG"
  ]
}
