{
  "name": "Empty Plain",
  "environment": "clear",
  "properties": {},
  "grid": [
    [
      "F",
      "F",
      "F",
      "F",
      "F",
      {
        "type": "D",
        "target": "map001.json",
        "spawn": {
          "x": 5,
          "y": 15
        }
      },
      "F",
      "F",
      "F",
      "F",
      "F"
    ],
    ["F", "G", "G", "G", "G", "G", "G", "G", "G", "G", "F"],
    ["F", "G", "F", "G", "G", "G", "G", "G", "G", "G", "F"],
    ["F", { "type": "N", "npc": "braga", "element": "fire" }, "F", "G", "G", "G", "G", "G", "G", "G", "F"],
    ["F", "G", "F", "G", "G", "G", "G", "G", "G", "G", "F"],
    ["F", "G", "G", "G", "G", "G", "G", "G", "G", "G", "F"],
    ["F", "G", "G", "G", "G", "G", "G", "G", "G", "G", "F"],
    ["F", "G", "G", "G", "G", "G", "G", "G", "F", "G", "F"],
    ["F", "G", "G", "G", "G", "G", "G", "G", "F", "G", "F"],
    ["F", "G", "G", "G", "G", "G", "G", "G", "F", "G", "F"],
    ["F", "G", "G", "G", "G", "G", "G", "G", "G", "G", "F"],
    ["F", "G", "G", "G", "G", "G", "G", "G", "G", "G", "F"],
    ["F", "G", "G", "G", "G", "G", "G", "G", "G", "G", "F"],
    ["F", "G", "G", "G", "F", "F", "F", "G", "G", "G", "F"],
    ["F", "G", "G", "G", "G", "G", "G", "G", "G", "G", "F"],
    ["F", "F", "F", "F", "F", "F", "F", "F", "F", "F", "F"]
  ]
}
